----- beach -----
nNode = 13;
loc[nNode][2] = {
    {25,  5}, { 5, 25}, {10, 50}, { 5, 75},
    {30, 50}, {50, 30}, {70, 10}, {90, 10},
    {90, 50}, {70, 50}, {50, 70}, {25, 95},
    {90, 90}
};
adj[nNode][nNode] = {
    { 0, 28, -1, -1, -1, 35, -1, -1, -1, -1, -1, -1, -1},
    {28,  0, 26, 50, -1, -1, -1, -1, -1, -1, -1, -1, -1},
    {-1, 26,  0, 26, 20, -1, -1, -1, -1, -1, -1, -1, -1},
    {-1, 50, 26,  0, 35, -1, -1, -1, -1, -1, -1, 28, -1},
    {-1, -1, 20, 35,  0, 28, -1, -1, -1, -1, 28, -1, -1},
    {35, -1, -1, -1, 28,  0, 28, -1, -1, 28, -1, -1, -1},
    {-1, -1, -1, -1, -1, 28,  0, 20, -1, 40, -1, -1, -1},
    {-1, -1, -1, -1, -1, -1, 20,  0, 40, -1, -1, -1, -1},
    {-1, -1, -1, -1, -1, -1, -1, 40,  0, 20, -1, -1, -1},
    {-1, -1, -1, -1, -1, 28, 40, -1, 20,  0, 28, -1, 44},
    {-1, -1, -1, -1, 28, -1, -1, -1, -1, 28,  0, 35, -1},
    {-1, -1, -1, 28, -1, -1, -1, -1, -1, -1, 35,  0, 65},
    {-1, -1, -1, -1, -1, -1, -1, -1, -1, 44, -1, 65,  0}
};

----- city -----
nNode = 23
loc[nNode][2] = {
    { 2,  2}, {50,  5}, {98,  2}, {96, 50}, {98, 98}, {50, 95}, { 5, 50},
    { 8, 92}, {35, 92}, {65, 92}, {92, 92},
    {92, 68}, {65, 68}, {35, 68}, { 8, 68},
    { 8, 32}, {35, 32}, {65, 32}, {92, 32},
    {92,  8}, {65,  8}, {35,  8}, { 8,  8}
};
adj[nNode][nNode] = {
    { 0, 48, -1, -1, -1, -1, 48, -1, -1, -1, -1, -1, -1, -1, -1, -1, -1, -1, -1, -1, -1, -1, -1},
    {48,  0, 48, -1, -1, -1, -1, -1, -1, -1, -1, -1, -1, -1, -1, -1, -1, -1, -1, -1, 16, 16, -1},
    {-1, 48,  0, 48, -1, -1, -1, -1, -1, -1, -1, -1, -1, -1, -1, -1, -1, -1, -1, -1, -1, -1, -1},
    {-1, -1, 48,  0, 48, -1, -1, -1, -1, -1, -1, 19, -1, -1, -1, -1, -1, -1, 19, -1, -1, -1, -1},
    {-1, -1, -1, 48,  0, 48, -1, -1, -1, -1, -1, -1, -1, -1, -1, -1, -1, -1, -1, -1, -1, -1, -1},
    {-1, -1, -1, -1, 48,  0, -1, -1, 16, 16, -1, -1, -1, -1, -1, -1, -1, -1, -1, -1, -1, -1, -1},
    {48, -1, -1, -1, -1, -1,  0, -1, -1, -1, -1, -1, -1, -1, 19, 19, -1, -1, -1, -1, -1, -1, -1},
    {-1, -1, -1, -1, -1, -1, -1,  0, 27, -1, -1, -1, -1, -1, 24, -1, -1, -1, -1, -1, -1, -1, -1},
    {-1, -1, -1, -1, -1, 16, -1, 27,  0, 30, -1, -1, -1, 24, -1, -1, -1, -1, -1, -1, -1, -1, -1},
    {-1, -1, -1, -1, -1, 16, -1, -1, 30,  0, 27, -1, 24, -1, -1, -1, -1, -1, -1, -1, -1, -1, -1},
    {-1, -1, -1, -1, -1, -1, -1, -1, -1, 27,  0, 24, -1, -1, -1, -1, -1, -1, -1, -1, -1, -1, -1},
    {-1, -1, -1, 19, -1, -1, -1, -1, -1, -1, 24,  0, 27, -1, -1, -1, -1, 45, 36, -1, -1, -1, -1},
    {-1, -1, -1, -1, -1, -1, -1, -1, -1, 24, -1, 27,  0, 30, -1, -1, 47, -1, 45, -1, -1, -1, -1},
    {-1, -1, -1, -1, -1, -1, -1, -1, 24, -1, -1, -1, 30,  0, 27, 45, -1, 47, -1, -1, -1, -1, -1},
    {-1, -1, -1, -1, -1, -1, 19, 24, -1, -1, -1, -1, -1, 27,  0, 36, 45, -1, -1, -1, -1, -1, -1},
    {-1, -1, -1, -1, -1, -1, 19, -1, -1, -1, -1, -1, -1, 45, 36,  0, 27, -1, -1, -1, -1, -1, 24},
    {-1, -1, -1, -1, -1, -1, -1, -1, -1, -1, -1, -1, 47, -1, 45, 27,  0, 30, -1, -1, -1, 24, -1},
    {-1, -1, -1, -1, -1, -1, -1, -1, -1, -1, -1, 45, -1, 47, -1, -1, 30,  0, 27, -1, 24, -1, -1},
    {-1, -1, -1, 19, -1, -1, -1, -1, -1, -1, -1, 36, 45, -1, -1, -1, -1, 27,  0, 24, -1, -1, -1},
    {-1, -1, -1, -1, -1, -1, -1, -1, -1, -1, -1, -1, -1, -1, -1, -1, -1, -1, 24,  0, 27, -1, -1},
    {-1, 16, -1, -1, -1, -1, -1, -1, -1, -1, -1, -1, -1, -1, -1, -1, -1, 24, -1, 27,  0, 30, -1},
    {-1, 16, -1, -1, -1, -1, -1, -1, -1, -1, -1, -1, -1, -1, -1, -1, 24, -1, -1, -1, 30,  0, 27},
    {-1, -1, -1, -1, -1, -1, -1, -1, -1, -1, -1, -1, -1, -1, -1, 24, -1, -1, -1, -1, -1, 27,  0}
};


----- hill -----
nNode = 12
loc[nNode][2] = {
    { 0,  5}, {40, 10}, {70, 20}, {95,  5},
    {95, 55}, {60, 55}, {25, 45}, { 5, 45},
    { 5, 70}, { 5, 95}, {60, 95}, {95, 95}
};
adj[nNode][nNode] = {
    { 0, 40, -1, 95, -1, -1, -1, 40, -1, -1, -1, -1},
    {40,  0, 31, 56, -1, -1, 38, -1, -1, -1, -1, -1},
    {-1, 31,  0, -1, -1, 36, -1, -1, -1, -1, -1, -1},
    {95, 56, -1,  0, 50, -1, -1, -1, -1, -1, -1, -1},
    {-1, -1, -1, 50,  0, 35, -1, -1, -1, -1, -1, 40},
    {-1, -1, 36, -1, 35,  0, 36, -1, -1, -1, 40, -1},
    {-1, 38, -1, -1, -1, 36,  0, 20, 32, -1, 61, -1},
    {40, -1, -1, -1, -1, -1, 20,  0, 25, -1, -1, -1},
    {-1, -1, -1, -1, -1, -1, 32, 25,  0, 25, -1, -1},
    {-1, -1, -1, -1, -1, -1, -1, -1, 25,  0, 55, -1},
    {-1, -1, -1, -1, -1, 40, 61, -1, -1, 55,  0, 35},
    {-1, -1, -1, -1, 40, -1, -1, -1, -1, -1, 35,  0}
};
